NO ./textures/sun.xpm
SE ./textures/eco_terrorist.xpm
WE ./textures/afa.xpm
EA ./textures/cop28.xpm
F 0,0,0
C 255,255,255

1111111111
1000000001
10N0000001
1000000001
1111111111
